De Manhã Bem Cedo Busco 

1.

De man	hã bem 	cedo busco, 	
De 	Jesus, a 	direç	ão, 	
Pra s	eguir sempre Seus 	passos, 	
No 	conforto ou 	na afli	ção.	
Coro.  El	e me ama, Ele 	me ama,	
Cr	isto me ama, bem o 	sei.	
Tenho a pro	va no Cal	vário;	
Para 	sempre a	ma-lo-	ei.	

2.
Eu, em	bora pe	quenino,	
Obe	deço ao Se	u man	dar.	
Sigo a	estrada que Ele 	mostra,	
Sem	temer nem h	esitar.		
3.
Ele é 	forte, 	me protege, 	
E m	e guarda 	de pe	car. 	
Se ten	tado corro a Ele, 		
Que 	me livra se	m tard	ar.	

