Vigiar e Orar 
1.

Bem de ma	nhã, embora o céu se	reno	
Pareça um 	dia calmo anun	ciar,	
Vigia e 	ora; o 	coração pe	queno		
Um tempo	ral pode 	abrigar.		

Coro
Bem de ma	nhã, 	e sem ces	sar;		
Vigi	ar sim	, e 	orar.		

2.
Ao meio-	dia, quando os sons da 	Terra 	
Abafam m	ais de Deus a voz de a	mor, 	
Recorre 	à oraçã	o, evita a 	guerra, 		
E goza 	paz com o 	Senhor.		

3.
Ao fim 	do dia, após os teus lid	ares, 	
Relembr	a as bênçãos do celeste 	amor,	
E conta a 	Deus 	prazeres 	e pesares, 		
Deixan	do em Suas 	mãos a dor.		


4.
E sem ces	sar, vigia a cada instan	te,	
Que o ini	migo ataca sem parar; 		
Só com 	Jesus, 	em comun	hão cons	tante, 	
Pode o 	mortal ao C	éu chegar		

